11111111111111111111111111
10C0000000000000000000C001
10000000000X00000000000001
10000000000000000000000001
10P000X0010E01000X00000001
10000000000000000000000001
10C00000000X0000000000C001
11111111111111111111111111
