11111111111111
10010000000C11
1P000X11110011
100011E0000011
11111111111111
11111111111111
