1111111
10001C1
1001011
1P000E1
1111111
