1111111
10001C1
1000101
1P0C0E1
1111111
