111111111111
100P00C000E11
111111111111
