111111111111111111111111111111
110P0E1C01C100C000100010000001
100111100100011101000010111101
10C101001111010001011010010101
101000000010001011011011010101
1001011110001C1001011001010001
101C00111111110011010100010101
1001100000001C1010000011010111
110101111011101000111111010001
10010010101C001010100C01011101
10110C101011001010101010000101
10110110101C101010101011110101
10100100C010001010101000010101
10C00011100011101110110C011101
100010000010C11000000C1001C001
111111111111111111111111111111
